....................................
....................................
....................................
....................................
.........####################.......
....................................
....................................
....................................
....................................
###########.......##################
....................................
....................................
....................................
....................................
....................................
....................................
#######.....#########......#########
....................................
....................................
....................................
....................................
....................................
....................................
........################............
....................................
....................................
....................................
....................................
....................................
..............................T.....
##########.....#################....
....................................
....................................
....................................
....................................
.................T..................
####################.........#######
....................................
....................................
....................................
....................................
1...................................
...............................T....
####################################