########............................
....................................
....................................
....................................
.....................###############
....................................
....................................
....................................
....................................
###########.......##################
....................................
....................................
....................................
................####################
....................................
....................................
########....##########..............
....................................
....................................
....................................
....................................
....................................
....................................
..........#############.............
....................................
....................................
....................................
....................................
....................................
....................................
###########....#################....
....................................
....................................
....................................
....................................
....................................
#################...........########
....................................
....................................
....................................
1...................................
....................................
....................................
####################################