....................................
....................................
....................................
....................................
.........####################.......
....................................
....................................
....................................
....................................
###########.......##################
....................................
....................................
....................................
....................................
....................................
....................................
....................................
....................................
....................................
....................................
....................................
....................................
....................................
....................................
....................................
....................................
....................................
....................................
....................................
....................................
....................................
....................................
....................................
....................................
....................................
###########.......##################
....................................
....................................
....................................
....................................
....................................
1........T........T.................
....................................
####################################