....................
....................
....................
....................
....................
....................
....................
....................
.........###........
....................
....................
....###.......###...
....................
....................
####################
