########............................
....................................
###############.............########
....................................
..............###############.......
....................................
....................................
...................#############....
.........###........................
....................................
....................................
#######.......####..................
....................................
................###########.........
....................................
....................................
########......###########...........
....................................
............................########
....................................
###############......#########......
....................................
....................................
..........###########...............
....................................
..................##################
....................................
########............................
...............#####################
....................................
############........................
....................................
....................................
........############################
....................................
....................................
#################...................
....................................
....................................
########.....#########......########
....................................
.............##########.............
1...................................
####################################